1111111111111111111
1P00000000000000001
1011111110111111101
1010000010100000101
1010B00C10100B00101
1010000010100000101
1011111010101111101
1000001010100000101
1011101010101110101
101C001010100010101
1011111010111010101
10100000100000B0101
1010111111111110101
1010000000000C00101
1011111111111111101
100000000B000000E01
1111111111111111111