1111111111
1P000000E1
1000111001
1C001B0001
1000111001
1000000001
1111111111