11111111111
1P000001E11
1C1C1001111
11111111111